---------------
-.............-
-.............-
-....-----..p.-
-.............-
-....--.--....-
-....-...-....-
-....-...-....-
-....--.--....-
-.............-
-....-----....-
-.............-
-.............-
-.............-
---------------