---------------
-.............-
-.............-
-...-.....-...-
-.............-
-.............-
-..---...---..-
-..-.......-..-
-..---------..-
-.............-
-.............-
-.............-
-.............-
-.............-
---------------