---------------
-.............-
-..e..........-
-....-----..p.-
-.............-
-....--.--....-
-....-...-....-
-....-...-....-
-....--.--..e.-
-.............-
-....-----....-
-.............-
-......e......-
-.............-
---------------